LLLLLLLLLLLL
LP...P...P.L
LPPPPPPPPPPL
LP...P.G.P.L
LP...P...P.L
LPPPPPPPPP.L
LP.....T.P.L
LP.....T.P.L
LP.....T.P.L
LPPPPPPPPPPL
LP.......P.L
LLLLLLLLLLLL
