LLLLLLLLLLLL
LP..P....P.L
LPPPPPPPPPPL
LP..P....P.L
LP..PPPPPP.L
LPT.P.G.TP.L
LPT.P...TP.L
LP..PPPPPP.L
LP..P....P.L
LPPPPPPPPPPL
LP.......P.L
LLLLLLLLLLLL
