LLLLLLLLLLLL
LP...P...P.L
LPPPPPPPPPPL
LP...P.G.P.L
LP...P...P.L
LPPPPPPPPPPL
LP.T..T..P.L
LP.T.....P.L
LP.T.....P.L
LPPPPPPPPPPL
LP.T.....P.L
LLLLLLLLLLLL
