LLLLLLLLLLLL
LP...P...P.L
LPPPPPPPPPPL
LP...P.T.P.L
LP...P.T.P.L
LPPPPPPPPPPL
LP...P...P.L
LPTG.P..TP.L
LP...P...P.L
LPPPPPPPPPPL
LP.T.....P.L
LLLLLLLLLLLL
