LLLLLLLLLLLL
LP...P...P.L
LP...P...P.L
LP..GP...P.L
LP...P...P.L
LPTTTPTTTPPL
LP.......P.L
LP.......P.L
LP.......P.L
LPPPPPPPTP.L
LP.......P.L
LLLLLLLLLLLL
