LLLLLLLLLLLL
L..T.P...P.L
L....P...PPL
L.TTTP...P.L
L....P.T.P.L
LPPPPPPPPPPL
L.T..P...P.L
L.T..P..TP.L
L.G..P...P.L
L....P...P.L
L....P...P.L
LLLLLLLLLLLL
